NO ./IMG_1387.png
SO ./IMG_1387.png
WE ./IMG_1387.png
EA ./IMG_1387.png
CO ./collectible.png

F 138,206,226
C 0,30,60

        1111111111111111111111111
        1000000000110000000000001
        101100000111000000c000001
        1001000000000000000000001
111111111011000001110000000000001
100000000011000001110001110111111
11110111111101011100000010001
11110111111000011101010010001
110c100011000000111000N0010001
100100001000000001100000010001
10000001000000000011010010001
11110000000000000000000000001
11110111111101011100011010c01 
11111111 1111111 111111111111