NO ./IMG_1387.png
SO ./IMG_1387.png
WE ./IMG_1387.png
EA ./IMG_1387.png

F 138,206,226
C 0,30,60

111111111111111111111111111111111
10W000000000000000000000000000001
111111111111111111111111111111111
