NO ./IMG_1387.png
SO ./IMG_1387.png
WE ./IMG_1387.png
EA ./IMG_1387.png

F 138,206,226
C 0,30,60

1111111111111111111111111111111111111111
1111111111000000000000000000001111111111
1111111100000000000000000000000011111111
1111111100000000000000000000000011111111
1111110000000000000000000000000000111111
1111110000000000000000000000000000111111
1111000000000000000000000000000000001111
1111000000000000000000000000000000001111
1100000000000000000000000000000000000011
1100000000000000000000000000000000000011
1000000000000000000000000000000000000001
1000000000000000000000000000000000000001
1000000000000000000000000000000000000001
1000000000000000000000000000000000000001
1000000000000000000000000000000000000001
1000000000000000000000000000000000000001
1000000000000000000000000000000000000001
1000000000000000000000000000000000000001
1000000000000000000000000000000000000001
1000000000000000000000000000000000000001
1000000000000000000000000000000000000001
100000000000000000N000000000000000000001
1000000000000000000000000000000000000001
1000000000000000000000000000000000000001
1000000000000000000000000000000000000001
1000000000000000000000000000000000000001
1000000000000000000000000000000000000001
1000000000000000000000000000000000000001
1000000000000000000000000000000000000001
1000000000000000000000000000000000000001
1000000000000000000000000000000000000001
1100000000000000000000000000000000000011
1100000000000000000000000000000000000011
1111000000000000000000000000000000001111
1111110000000000000000000000000000111111
1111110000000000000000000000000000111111
1111111100000000000000000000000011111111
1111111100000000000000000000000011111111
1111111111000000000000000000001111111111
1111111111111111111111111111111111111111