1111111111
1000000001
1001111101
1001000001
1001000001
1001000N01
1001111101
1000000001
1111111111