NO ./texture_N.png
SO ./texture_S.png
WE ./texture_W.png
EA ./texture_E.png

F 50,100,0
C 0,30,60

1111111111111111111111111111
1000000000000000000000000001
1000001111111111111111000001
1000001100000000000000000001
1000001100000000000000000001
1000001100000000000000000001
1000001100000000000000000001
1000001100000000000000000001
1000001100000000000000000001
1000001100000000000000000001
1000001100000000000000000001
1000001100000000000000000001
1000001100000000000000000001
1000001100000000000000000001
1000001100000000000000000001
1000001100000000000000000001
1000001100000000000000000001
1000001100000000000000000001
1000001100000000000000000001
10000011000000N0000000000001
1000001100000000000000000001
1000001100000000000000000001
1000001111111111111110000001
1000000000000000000000000001
1111111111111111111111111111