NO ./texture/moon_6.png
SO ./texture/moon_8.png
WE ./texture/moon_9.png
EA ./texture/moon_7.png

F 146,150,147
C 42,45,56
H 2

1111111111111111111111111111111111111111
1111000000000000000000000000000000001111
11000000000000000000000000000W0000000011
1100000000000000000101100000000000000011
100000001000000000010c1000000000000000011111111111111
10000000100000000001111000000000000000010100000110111
10000000100000000000000000000000000000010000000110111
10000000100000000000000000000000000000010111111110011
10000000100000001111111111111111000000010000000110111
1000000010000000000000000000000000000001011111011Z111
1000000010000000000000000000000000000001000000011D111
10000000000000111111110000000000000111110011111100111
1000000000000011111111000000000000000000c000100100111
10000000000000111111110000000000000111110000100100111
10000000000000100000000000000000000000010000100100111
10000000000000100000000000000000000000010000000100111
10000000000000000000000000000000000001110111111100111
10000011111111111111111111111111111111000000c00000111
10000000000000000000000000000000000000011111111111111
1111111111111111111111111111111111111111