NO ./texture/texture_N2.png
SO ./texture/texture_S.png
WE ./texture/texture_W.png
EA ./texture/texture_E.png

F 138,206,226
C 0,30,60

1111111111111111111111111111111111111111
1000000000000000000000000000001111111111
1000000S00000000000000000000000011111111
1000000000000000000000000000000011111111
1000000000000000000000000000000001111111
1000000000000000000000000000000000111111
1000000000000000000000000000000000001111
1000000000000000000000000000000000001111
1000000000000000000000000000000000000011
1000000000000000000000000000000000000011
10000000000000000000000000000000000000011111111111111
10000000000000000000000000000000000000010000000100111
10000000000000000000000000000000000000010000000000111
10000000000000000000000000000000000000010111111100111
10000000000000000000000000000000000000010000000100111
10000000000000000000000000000000000000011111110100111
10000000000000000000000000000000000000010000000100111
10000000000000000000000000000000000000010011111100111
10000000000000000000000000000000000000010000100100111
10000000000000000000000000000000000000010000100100111
10000000000000000000000000000000000000010000000100111
10000000000000000000000000000000000000011111111100111
10000000000000000000000000000000000000000000000000111
10000000000000000000000000000000000000011111111111111
1000000000000000000000000000000000000001
1000000000000000000000000000000000000001
1000000000000000000000000000000000000001
1000000000000000000000000000000000000001
1000000000000000000000000000000000000001
1000000000000000000000000000000000000001
1000000000000000000000000000000000000001
1000000000000000000000000000000000000001
1100000000000000000000000000000000000011
1100000000000000000000000000000000000011
1111000000000000000000000000000000001111
1111110000000000000000000000000000111111
1111110000000000000000000000000000111111
1111111100000000000000000000000011111111
1111111100000000000000000000000011111111
1111111111000000000000000000001111111111
1111111111111111111111111111111111111111