NO ./texture/IMG_1387.png
SO ./texture/IMG_1387.png
WE ./texture/IMG_1387.png
EA ./texture/IMG_1387.png

F 138,206,226
C 0,30,60

111111111111111111111111111111111
10W000000000000000000000000000001
111111111111111111111111111111111
