
NO ./texture/moon_N.png
SO ./texture/moon_S.png
WE ./texture/cloud.png
EA ./texture/moon_E.png
BO ./texture/moon_E.png
SK ./texture/sky2.png
IN ./texture/intro.png

F 119,121,122
C 42,45,56 5,5,20
H 2

1111111111111122222222222222211111111111
1111111111000000000000000000002111111111
1111111100000000000000000000000011111111
1111111100000000000000000000000011111111
1111110000000000000000000000000001111111
1111110000000000000000000000000000211111
1111000000000000000000000000000000001111
1111000000000000000000000000000000002111
1100000000000000000000000000000000000011
1100000000000000000000000000000000000011
10000000000000000000000000000000000000011111111111111
10000000000000000000000000000000000000010000000100111
10000000000000000000000000000000000000010000000000111
10000000000000000000000000000000000000010111111100111
10000000000000000000000000000000000000010000000100111
10000000000000000000000000000000000000011111110100111
10000000000000000000000000000000000000010000000100111
10000000000000000000000000000000000000010011111100111
10000000000000000000000000000000000000010000100100111
10000000000000000000000000000000000000010000100100111
10000000000000000000000000000000000000010000000100111
10000000000000000000000000000000000000011111111100111
1W000000000000000000000000000000000000000000000000111
10000000000000000000000000000000000000011111111111111
1000000000000000000000000000000000000001
1000000000000000000000000000000000000001
1000000000000000000000000000000000000001
1000000000000000000000000000000000000001
1000000000000000000000000000000000000001
1000000000000000000000000000000000000001
1000000000000000000000000000000000000001
1000000000000000000000000000000000000001
1100000000000000000000000000000000000011
1100000000000000000000000000000000000011
1111000000000000000000000000000000001111
1111110000000000000000000000000000111111
1111110000000000000000000000000000111111
1111111100000000000000000000000011111111
1111111100000000000000000000000011111111
1111111111000000000000000000001111111111
1111111111111111111111111111111111111111