NO ./texture/texture_N2.png
SO ./texture/texture_S.png
WE ./texture/texture_W.png
EA ./texture/texture_E.png

F 50,100,0
C 0,30,60

1111111111111111
1000000000000001
1000001111100001
1000000000000001
1000000000000001
1000c00000000001
1001000000000001
1001000000000001
1000000000000001
100000000S000001
1000000000000001
10010000c0000001
10000000000000c1
1111111111111111