NO ./texture/IMG_1387.png
SO ./texture/IMG_1387.png
WE ./texture/IMG_1387.png
EA ./texture/IMG_1387.png

F 138,206,226
C 0,30,60

        1111111111111111111111111
        1000000000110000000000001
        1011000001110000000000001
        1001000000000000000000001
111111111011000001110000000000001
100000000011000001110111110111111
11110000000000000000000000001
11110000000000000000000000001
11110000000000N00000000000001
11110000000000000000000000001
11110000000000000000000000001
11110111111101011100011010001 
11111111111111111111111111111