
NO ./texture/moon_8.png
SO ./texture/moon_8.png
WE ./texture/moon_9.png
EA ./texture/moon_7.png
CO ./texture/collectible.png

F 146,150,147
C 42,45,56
H 1

1111111111111111111111111111111111111111
1111111111000000000000000000001111111111
1111111100000000000000000000000011111111
1111111100000000000000000000000011111111
1111110000000000000000000000000001111111
1111110000000000000000000000000000111111
1111000000000000000000000000000000001111
1111000000000000000000000000000000001111
1100000000000000000000000000000000000011
1100000000000001111101100000000000000011
100000000000000100000c1000000000000000011111111111111
10000000000000010000001000000000000000010100000110111
10000000000000011111111000000000000000010000000110111
10000000000000000000000000000000000000010111111110111
1000000000000000000000000000000000000001000000011Z111
1000000000000000000000000000000000000001011111011D111
1000000000000000000000000000000000000001c000000100011
10000000000000000000000000000000000000010011111100011
10000000000000000000000000000000000000010000100100011
10000000000000000000000000000000000000010000100100011
10000000000000000000000000000000000000010000100100011
10000000000000000000000000000000000000010000000100011
10000000000000000000000000000000000000010111111100011
100000000000000000000000000000000E0000000000000000011
100000000c0000000000000000000000000000011111111111111
1000000000000000000000000000000000000001
1000000000000000000000000000000000000001
1000000000000000000000000000000000000001
1000000000000000000000000000000000000001
1000000000000000000000000000000000000001
1000000000000000000000000000000000000001
1000000000000000000000000000000000000001
1000000000000000000000000000000000000001
1100000000000000000000000000000000000011
1100000000000000000000000000000000000011
1111000000000000000000000000000000001111
1111110000000000000000000000000000111111
1111110000000000000000000000000000111111
1111111100000000000000000000000011111111
1111111100000000000000000000000011111111
1111111111000000000000000000001111111111
1111111111111111111111111111111111111111