NO ./texture/IMG_1387.png
SO ./texture/IMG_1387.png
WE ./texture/IMG_1387.png
EA ./texture/IMG_1387.png

F 138,206,226
C 0,30,60

        1111111111111111111111111
        1000000000110000000000001
        101100000111000000000c001
        100100000000000000000000001
111111111011000001110000000000001
100000000011000001110111110111111
11110111111101011100000010001
11110111111000011101010010001
110c10001100000011100000010001
100100001000000001100000010001
10000001000000000011010010001
11110000000000000000000000001
111101111111N1011100011010c01 
11111111 1111111 111111111111