NO ./texture/texture_N.png
SO ./texture/texture_S.png
WE ./texture/texture_W.png
EA ./texture/texture_E.png

F 138,206,226
C 0,30,60

1111111111111111111111111
1000000000110000000000001
1011000001110001000000001
1001000000000001000000001
1001000000011111111111001
1001000000000000000000001
1111011111110100111110001
1111011111110100000110001
1100000000011100000111101
1001000010000000011000001
1111000000111111111011101
1111000000000000001000001
11110111010111000110111N1 
1111111111111111111111111