NO ./texture/IMG_1387.png
SO ./texture/IMG_1387.png
WE ./texture/IMG_1387.png
EA ./texture/IMG_1387.png
CO ./texture/Fire.png

F 138,206,226
C 0,30,60

1111111111111111111111111
1000000000110000000000001
101100000111000000c000001
1001000000000000000000001
1001000000000000000000001
1001000000000000000000001
1111011111110100000110001
1111011111110100000110001
110c1000000111000N0010001
1001000010000000011010001
1111000000000000000000001
1111000000000000000000001
1111011101011100011010c01 
1111111111111111111111111