SO ./texture/Fire.png
WE ./texture/Fire.png
EA ./texture/Fire.png
NO ./texture/Fire.png

F 252,72,4
C 131,27,4
H 2

1111111111111111111111111
1000000000000000000000001
1000001111111111111000001
1000001100000000000000001
1000001100000000000000001
1000001100000000000000001
1000001100000000000000001
1000001100000000000000001
1000001100000000000000001
1000001100000000000000001
1000001100000000000000001
1000001100000000000000001
1000001100000000000000001
1000001100000000000000001
1000001100000000000000001
1000001100000000000000001
1000001100000000000000001
1000001100000000000000001
1000001100000000000000001
10000011000000N0000000001
1000001100000000000000001
1000001100000000000000001
1000001111111111111000001
1000000000000000000000001
1111111111111111111111111
