
NO ./texture/moon_8.png
SO ./texture/moon_8.png
WE ./texture/moon_9.png
EA ./texture/moon_7.png
CO ./texture/collectible.png

F 146,150,147
C 42,45,56
H 2

1111111111111111111111111111111111111111
1111111111000000000000000000001111111111
1111111100000000000000000000000011111111
1111111100000000000000000000000011111111
1111110000000000000000000000000001111111
1111110000000000000000000000000000111111
1111000000000000000000000000000000001111
1111000000000000000000000000000000001111
1100000000000000000000000000000000000011
1100000000000000000000000000000000000011
10000000000000000000000000000000000000011111111111111
10000000000000000000000000000000000000010100000100111
1000000000000000000000000000000000000001000000000111
10000000000000000000000000000000000000010111111100111
10000000000000000000000000000000000000010000000100111
10000000000000000000000000000000000000010111110100111
10000000000000000000000000000000000000010000000100111
10000000000000000000000000000000000000010011111100111
10000000000000000000000000000000000000010000100100111
10000000000000000000000000000000000000010000100100111
10000000000000000000000000000000000000010000100100111
10000000000000000000000000000000000000010000000111111
10000000000000000000000000000000000000010111111100111111111111111111111
100000000000000000000000000000000000ccc0000000D000EZ0000000000000000002
10000000000000000000000000000000000000011111111111111111111111111111111
1000000000000000000000000000000000000001
1000000000000000000000000000000000000001
1000000000000000000000000000000000000001
1000000000000000000000000000000000000001
1000000000000000000000000000000000000001
1000000000000000000000000000000000000001
1000000000000000000000000000000000000001
1000000000000000000000000000000000000001
1100000000000000000000000000000000000011
1100000000000000000000000000000000000011
1111000000000000000000000000000000001111
1111110000000000000000000000000000111111
1111110000000000000000000000000000111111
1111111100000000000000000000000011111111
1111111100000000000000000000000011111111
1111111111000000000000000000001111111111
1111111111111111111111111111111111111111