
   NO  ./texture/IMG_1387.png
SO  ./texture/IMG_1387.png

   WE  ./texture/IMG_1387.png
EA  ./texture/IMG_1387.png

G
F  138,206,226
C      0,30,60

111111
100101
1000N1
1    1
111111