NO ./texture/IMG_1387.png
SO ./texture/IMG_1387.png
WE ./texture/IMG_1387.png
EA ./texture/IMG_1387.png
CO ./texture/collectible.png


F 138,206,226
C 0,30,60

1111111111111111111111111
10ZD0000ccc000000000000W1
1111111111111111111111111