
NO ./texture/IMG_1387.png
SO ./texture/IMG_1387.png
WE ./texture/IMG_1387.png
EA ./texture/IMG_1387.png
CO ./texture/collectible.png

F 138,206,226
C 0,30,60

1111111111111111111111111111111111111111
1111111111000000000000000000001111111111
1111111100000000000000000000000011111111
1111111100000000000000000000000011111111
1111110000000000000000000000000001111111
1111110000000000000000000000000000111111
1111000000000000000000000000000000001111
1111000000000000000000000000000000001111
1100000000000000000000000000000000000011
1100000000000000000000000000000000000011
10000000000000000000000000000000000000011111111111111
10000000000000000000000000000000000000010000000100111
10000000000000000000000000000000000000010000000000111
10000000000000000000000000000000000000010111111100111
10000000000000000000000000000000000000010c00000100111
10000000000000000000000000000000000000011111110100111
10000000000000000000000000000000000000010000000100111
10000000000000000000000000000000000000010011111100111
10000000000000000000000000000000000000010000100100111
10000000000000000000000000000000000000010000100100111
10000000000000000000000000000000000000010000000100111
10000000000000000000000000000000000000011111111100111
10000000000000000000000000000E000000000c0000000000111
10000000000000000000000000000000000000011111111111111
1000000000000000000000000000000000000001
1000000000000000000000000000000000000001
1000000000000000000000000000000000000001
100000000000000000000000000000000000c001
1000000000000000000000000000000000000001
1000000000000000000000000000000000000001
1000000000000000000000000000000000000001
1000000000000000000000000000000000000001
1100000000000000000000000000000000000011
1100000000000000000000000000000000000011
1111000000000000000000000000000000001111
1111110000000000000000000000000000111111
1111110000000000000000000000000000111111
1111111100000000000000000000000011111111
1111111100000000000000000000000011111111
1111111111000000000000000000001111111111
1111111111111111111111111111111111111111