NO ./texture/texture_N2.png
SO ./texture/texture_S.png
WE ./texture/texture_W.png
EA ./texture/texture_E.png

F 50,100,0
C 0,30,60

1111111111111111
1000000000000001
1000001100000001
1000000000000001
1000000000100001
1000000000000001
1001000000000001
1001000000001001
1000000000000001
100000000W000001
1000000100010001
1000000000000001
1000000000000001
1111111111111111