NO ./texture/IMG_1387.png
SO ./texture/IMG_1387.png
WE ./texture/IMG_1387.png
EA ./texture/IMG_1387.png
CO ./texture/collectible.png

F 138,206,226
C 0,30,60

1111111111111111111111111
1000000000110000000000001
1011000001110001000000001
1001000000000001000000001
1001000000011111111111101
1001000000000000000000101
1111011111110100111110101
1111011111110100000110101
1100000000011100000110101
1001000010000000011000001
1111000000111111111011101
1111000000000000001000001
1000000000110000000000001
1011000001110001000000001
1001000000000001000000001
1001000000011111111111101
1001000000000000000000101
1111011111110100111110101
1111011111110100000110101
1100000000011100000110101
1001000010000000011000001
1111000000111111111011101
1111000000000000001000001
1000000000110000000000001
1011000001110001000000001
1001000000000001000000001
1001000000011111111111101
1001000000000000000000101
1111011111110100111110101
1111011111110100000110101
1100000000011100000110101
100100001000c000011000c01
1111000000111111111011101
1111000000000c00001000001
11110111010111000110111N1 
1111111111111111111111111