NO ./texture/IMG_1387.png
SO ./texture/IMG_1387.png
WE ./texture/IMG_1387.png
EA ./texture/IMG_1387.png
CO ./texture/barrel.png


F 138,206,226
C 0,30,60

1111111111111111111111111
1000000000110000000000001
1000000000110000000000001
10000000001100000c0000001
1000000000110000000000001
1000000000000000000000001
1000000000000000000000001
1000000000000000000000001
11110111010111000110111N1 
1111111111111111111111111