NO ./texture/IMG_1387.png
SO ./texture/IMG_1387.png
WE ./texture/IMG_1387.png
EA ./texture/IMG_1387.png
CO ./texture/collectible.png


F 138,206,226
C 0,30,60

1111111111111111111111111
1000000000110000000000001
1000000000110000000000001
10000000001100000cW000001
1000000000110000000000001
100000000000000c000000001
100000000000c000000000001
1000000000000000000000001
1111011101011100011011001 
1111111111111111111111111