NO ./texture/lines.png
SO ./texture/lines.png
WE ./texture/lines.png
EA ./texture/lines.png

F 50,100,0
C 0,30,60

        1111111111111111111111111
        1000000000110000000000001
        1011000000000000000000001
        1001000000000000000000001
111111111011000001110000000000001
100000000011000001110111010111111
100000000000011011100000010001
11000000000000011101010010001
11000000110101011100000010001
10000000001000001100000010001
10000000000000001101010010001
1100000111010101111101101000111
11110111 1110101 100011010N01 
11111111 1111111 111111111111