NO ./texture/IMG_1387.png
SO ./texture/IMG_1387.png
WE ./texture/IMG_1387.png
EA ./texture/IMG_1387.png
CO ./texture/collectible.png


F 138,206,226
C 0,30,60

1111111111111111111111111
10000000c0110000000000001
1000000000110000000000001
10000000001100000c0000001
1000000000110000000000001
10000000001100000c0000001
1000000000110000000000001
100000000000000c000000001
100000000000c00000000N001
1000000000000000000000001
1111011101011100011011001 
1111011101011100011011001 
11110111010111c0011011001 
1111011101011100011011001 
1111011101011100011011N01 
1111111111111111111111111