NO ./texture/texture_N2.png
SO ./texture/texture_N2.png
WE ./texture/texture_N2.png
EA ./texture/texture_N2.png

F 50,100,0
C 0,30,60

1111111111111111
1000000000000001
1000001111100001
1000000000000001
1000000000000001
1000000000000001
1001000000000001
1001000000000001
1000000000000001
100000000S000001
1000000000000001
1001000000000001
1000000000000001
1111111111111111