
NO ./texture/moon_6.png
SO ./texture/moon_8.png
WE ./texture/moon_9.png
EA ./texture/moon_7.png

F 146,150,147
C 42,45,56

1111111111111111111111111111111111111111
1111111111000000000000000000001111111111
1111111100000000000000000000000011111111
1111111100000000000000000000000011111111
1111110000000000000000000000000001111111
1111110000000000000000000000000000111111
111100000000000111101110000000000001111
1111000000000001000000100000000000001111
1100000000000001000000100000000000000011
1100000000000001000000100000000000000011
10000000000000011100111000000000000000011111111111111
100000000000000111N0111000000000000000000100000110111
10000000000000011111111000000000000000010000000110111
10000000000000000000000000000000000000010111111110111
10000000000000000000000000000000000000010000000110111
10000000000000000000000000000000000000010111110110111
10000000000000000000000000000000000000010000000100011
11111111111111111111110000001111111111110011111100011
10000000000000000000000000000000000000010000100100011
10000001000000000000000000000000000000010000100100011
10000001000000000000000000000000000000010000100100011
11111111000000000000111111111111111111110000000100011
10000000000000000000000000000000001000010111111100011
10000000000000000000000000000000001000000000000000011
10000000000000000000000000001000001000011111111111111
1000000000000000000000000000100000100001
1000000000000000000000000000101111100001
1000000000000000000000000000100000100001
1000000000000000000000000000100000100001
1000000000000000000000000000100000100001
1000000001111111111111111111111111100001
1000000000000000000000000000000000000001
1000000000000000000000000000000000000001
1100000000000000000000000000000000000011
1100000001111111111111111111110000000011
1111000000000000000000000000000000001111
1111110000000000000000000000000000111111
1111110000000000000000000000000000111111
1111111100000000000000000000000011111111
1111111100000000000000000000000011111111
1111111111000000000000000000001111111111
1111111111111111111111111111111111111111